--------------------------------------------------------------------------------------------------------------------------------------------------------------------------------------------------------
--------------------------------------------------------------------------------------------------------------------------------------------------------------------------------------------------------
--------------------------------------------------------------------------------------------------------------------------------------------------------------------------------------------------------
--------------------------------------------------------------------------------------------------------------------------------------------------------------------------------------------------------
--------------------------------------------------------------------------------------------------------------------------------------------------------------------------------------------------------
-----XoXXo-----------o?X------------------------------------XX---oXo-MM----------XX--------o---------oXXX----X---XX?----o------------------------XXMo-----------XM--------XX----------------------------
---------?-------------------------------X?oXX-------------------Mo?MX--------------------oX---------Xo?----------------X----XXX-------------MX--------------------------o---?XXX--------------o--------
---------M--------------------------------oo------------------------------------o---------XoXX-------------------------------oX?X-----------X------------------------o?X-X-------------------XoXX-----v-
-----XX--X-------------------XMM---------XXXXX---X-----------------------------------------------XXM------------------------------XoM--------------------XXoMX---o---XMo---------ooX------------------f-
---------X-----------------------XMX-------------------------XXX-MMX-?-----------------------?X----------X?----------------------------------o-------------------XX?-------------XMX------------------f-
--------------ooo----X?--XXMXX--------------------------------------------------------------------------o----------------?X------------------?XM?o------------------------o--------------XXXoX--------f-
------T------?X?X----------------XM--------------------------T-------------------?XT-T---------------MXXX--------------------------------?X--------T-------------------T--XX-------------?MT----------f-
------|---------T----------oo-XoX----------------------------|---------------------|T|---M-----------T-----T---o-----------------------------------|-------T-----XXTT--|----o--------------|----------f-
----T-|---------|--T-----oXXXMT-----------------------------T|--------XXMo---------|||-------T-------|T----|--oX-XX--------------------------------|--?----|-------||--|--XXXX---XXX-------|---------Tf-
m---|-|---T-----|--|--TE------|-----TT----------------------||-E--E-E-E------------|||----T--|-------||----|-----E--------------E-T------------E---|-------|---T---||-E|---T------E--------|-----TT--|X-
XXXXXXXXXXXXXXXXXXXXXXXXXXXXXXXXXXXXXXXXXXXXXXXXXXXXXXXXXXXXXXXXXXXXXXXXXXXXXXXXXXXXXXXXXXXXXXXXXXXXXXXXXXXXXXXXXXXXXXXXXXXXXXXXXXXXXXXXXXXXXXXXXXXXXXXXXXXXXXXXXXXXXXXXXXXXXXXXXXXXXXXXXXXXXXXXXXXXXXXX
