--------------------------------------------------------------------------------------------------------------------------------------------------------------------------------------------------------
-Xo-------------B--------------?-X--X------------------------------------B-------o------------?---------------------------------X-------M----------------------------B--X-------------------------------
----M------------------------------------------X--------------------?-----X---------------------------------------------------X---------------------------------------o---------------------------------
-------------------------------------?-----------------B------------X--------------------?----------------------M---B---M-------------X-----------------------------------------------------------------
-----X----------------------------X---------------------X--------M-----------E------------------o-------------X------------X---------------------------?-------------XX---------------------------------
-------------?XXoX?X-?MX---------------X--------------------?XXX---------XXXXX---MX?--?--X?X?----Xo---------B------------MX?XX-----?-MMX?------------X-----------------XX------------------------XX-----
----------?-------------oX--------o----------??oXo-X-----MXX------o--------------------------X---------------X-------------------------------------------------E-M------------------oX--------XXX-------
-XoMMX------E-------------?------?X-X--X-------------oXXX--------X??-X------------------B-----------------------------------------------------X---B---XXMX---XXM--X----------MXX--oE------------------v-
--------B-------------M------------------o--B---------------------M----------------------------------M?M?X--B-----------M?---??M-oX-X----M?oM-o--XX--o---------------------------XXMXo----------------f-
----X------------?XXXM-------X-----------?M?Mo----XX---X-----------------o-------XMXMXX---X---E--?XX------?--?------------X------?----------BMX-X------------------------------------XXXXM---X-----o--f-
-ooX?X------------------------?--XMo----------------XXX------------o-----XXX---X-------------XM?------------------------------B-------E---------BMX---?oX-----------------?M-----------------------X--f-
----------------------------X-?X-T-T---TM---------X-X--------XX---oX-----T-------T--------o----Mo---?XM------?X---XT------------T-?oXoB--------------o-----B--M--MX--XEo-----------------------T------f-
---------T-----------------------|-|-XX|X-T--T-----T-----------o-XXX-X---|--T----|--?XX?X?-----X-------------------|---------T--|-X--B----T-T-----T--X------T--T-----MX?MX-----------TT--------|T---XTf-
------T--|------T--------T-------|-|---|--|--|-----|------?-M--X-----T--T|--|---T|-------------------X--T----------|----M-o--|-X|----T--T-|-|-----|-T-?T--o-|--|---------------------||--------||----|f-
mB-X--|-X|X-----|--X----E|--E----|-|---|--|--|-----|----XE-E----E----|--||--|---||-------T------T-------|---------X|--E------|--|----|--|-|-|-?---|-|--|--?-|T-|E-XE-------B-------T-||--------||----|X-
XXXXXXXXXXXXXXXXXXXXXXXXXXXXXXXXXXXXXXXXXXXXXXXXXXXXXXXXXXXXXXXXXXXXXXXXXXXXXXXXXXXXXXXXXXXXXXXXXXXXXXXXXXXXXXXXXXXXXXXXXXXXXXXXXXXXXXXXXXXXXXXXXXXXXXXXXXXXXXXXXXXXXXXXXXXXXXXXXXXXXXXXXXXXXXXXXXXXXXXX
