--------------------------------------------------------------------------------------------------------------------------------------------------------------------------------------------------------
---X-------------------------?------------------M-------------------------------------------B------------X------------------------------oB------------------------------M----------X--------------------
--------------------------------------------------------------X-----X----------------------------X----B---------------?----------?-E----------------------?----------------------X-----MX----X----------
--------------------------X----------------------------------------?----------------B------------------------------B--------------------------M---------------------------------------------------------
------------------X--?----?-------E-------------------------------------------X------------------?---------------M---E------------B-?-------------------------------------------B---X-------------------
-XXMX---------------X-----o---XXM----------X---o-------------XXoX--------B-E-XMM-X---XX-------o--o-------MX----------X-----o---------?XX--o------oM?X--------------------X-X-----XXX--------E--X--------
-------------MX?M??X-XX?MXXXMM---X---X-------M??XX--o--------------------oXXB------------X---XX-XXXo-------B?X--?-X----------------------XXX-------------------o-M?---------o--------?XXXM--X-----------
---------o-o-------------------o---------XoXX-----X?X------------------?------X---X---X-----X-----------------X------Eo--o---?XX-oX--------------------------XXXo-B--MMX----X----------------------o--v-
---------XMMo--------?o--------------------------X---B---------------Xo-------------MXX----o----o---XXo------X-------MXX?X-------?-----------X?o-XX------M?-----X--------oX---------------o--M----XXM-f-
-X?------------------oX--------------------------------------XXoXXXM?--B----------B--?----MXXMXX-X?-------------X---------------------B--------------------------XMo--------X-----X-------X-----------f-
------X---o------MX-------------------------?------------XXX---X--M------------------X-------o------------X-----------XM----------X-------X---------------------E------------?------oo----------------f-
---X-----XXoX--------------------XMXMX---------------MXXM----E----------T-----T-T----------T-X?--T--XXT--oX------?Xo----------?---X----X---------T--------------B-----------B-------XX------------X---f-
-------------T?----------------T----------T------T-------X-----B--------|XoM--|-|---TT---X-|-----|----|----------------------------X-----T---Mo--|----XX----------------------T--------------MXX?X-M-Tf-
--B-M---B----|---------------T-|-T------?o|--TT--|--------------T-------|-----|T|---||--T--|-----|--?-|T--------------------------T-X----|-------|--------------X-------XT-X--|----------------X-----|f-
m----------X-|T---T--T-----ET|-|-|-------?|--||-E|----?---T-Eo--|-------|-----|||--T||--|--|--?-E|----||----------E---------------|------|B------|-T-X--E--------M--T----|XX--|-----------------X--o-|X-
XXXXXXXXXXXXXXXXXXXXXXXXXXXXXXXXXXXXXXXXXXXXXXXXXXXXXXXXXXXXXXXXXXXXXXXXXXXXXXXXXXXXXXXXXXXXXXXXXXXXXXXXXXXXXXXXXXXXXXXXXXXXXXXXXXXXXXXXXXXXXXXXXXXXXXXXXXXXXXXXXXXXXXXXXXXXXXXXXXXXXXXXXXXXXXXXXXXXXXXX
