--------------------------------------------------------------------------------------------------------------------------------------------------------------------------------------------------------
------------------------------------o------------------------------------------------------X-----------------------------------X--------------------------------------------------X-----------------M---
--------------------------------------X--------------------?------------------------X------------------------------B--------------X--------------X------------------------------------------B-----------
---------------o----------------B-------------------------------------------------X------------------X----------------------------------------------------------E---X----X--------------------?---------
----------------------------------X------------------------X---XX-----------------------?X--------X-------------B--X------------------------------X-------------M------------------------X--------------
-------E-------------------X----------?----------o-------oXXo--------M----------------------------X----------M-----o--------------?XX?--------X---------------------------X------XX-XX-B---X------------
-----XoX-XXX-----------?---X-X---oX-E--------XMXX-----------XM---X?X-------X-Xo-------o--?o--X?------------------XoX?X--X---------E----?--o----------X-----------------------oXX?------X----------------
-----------------XMX--B--o----oM------X-----------------------------------------XM--X-X---X-B------------?----X--------------XXMM?X--M-?--X-------o----------X----oo-------M-----------------X--------v-
-------------XXXX--------XM------E-------------------M----------------XXMM--------o-o----B-----------X----------------X------------X--X----------X?oX---X----XM--XXX------X?X-------------X----------of-
-?X?X?-----------X-----------X---XXX-----------------XXoMX-----o-----X-------MX--XXM?---------------------------X----------------------------?-----B-----X-------------------X--------------X----XXX--f-
--------?-B-----------o----------------------o?oXXB-------X--MoXX?------------------------MX?M-----------XX--X-----------------------XX?XXX---------------------------?----------oXX------?---B------Xf-
---------Xo----------XX-----------o--------M-------------------M-------------X---B------TX--------T--M?XX--------------------T-X------------------------T--------------------------------MXXX---------f-
-X?XXT----XM?-----------X-T--T-T-----------T-------------------X-X-------o?X------------|---------|---X-----------T---T----E-|------------------------T-|----XXX---------------------X?X------T---?---f-
----X|-------------------T|--|-|--TT-------|-------T------T-----T-TT----------X-T-------|-T-------|---------B---M-|T--|------|------------------------|-|-------T-----T------------X----BT----|-------f-
m----|-------B-TE---E----||--|X|--||------T|E-----T|----T-|--T--|T||------------|T--TE-T|-|--E----|T-----------E--||--|------|----T----------X----T-B-|-|----X--|T----|--E-T-------TE-T--|E---|-------X-
XXXXXXXXXXXXXXXXXXXXXXXXXXXXXXXXXXXXXXXXXXXXXXXXXXXXXXXXXXXXXXXXXXXXXXXXXXXXXXXXXXXXXXXXXXXXXXXXXXXXXXXXXXXXXXXXXXXXXXXXXXXXXXXXXXXXXXXXXXXXXXXXXXXXXXXXXXXXXXXXXXXXXXXXXXXXXXXXXXXXXXXXXXXXXXXXXXXXXXXX
