--------------------------------------------------------------------------------------------------------------------------------------------------------------------------------------------------------
-------------o--------------------------------X-------X---------------------------------------------M--B---X--------------------------------?----------X---?---------------M----------------------------
-------M-------------------------------------------------------------X-X------------X--------X----------X------------------------------------------------------X-------------------------------------X--
-------------------------------------------M--------------------------------------X--------------------------------------------------------------X--------B---------------------------------------------
--M---------B------X---M--?---------X------------X-----o------o-------------------------?X--M---------------------------------------------------------X-----------M-------------------------------------
--------------X--------------X----------?----------------XM---X?-X---o----------------------------B--------X--?o-----XXo-oXMMX--------o--X-------------X------E-X--X-----------------o---X--------------
-o--------XX------------------------------E----o-----------?---E-----?------X--------------------o--?------------o-------------------XXoXX------------------o---XX-----E------------oX----------X--M----
-?XM-XX-------X---X----------------------X?--XXXX----------------o--------------X---X-X------?XXMX---------------Xo--------------?X----------------------MXX?o-------XX?M--------XX?-X------X---------v-
-------------?X--------------------------------------M-----------?XX------o---------o----B----------------o--------------XXMo-----X-----B------B-XX------------------E---X------X------o--------------f-
--o-E----X----------XM----------------------X--M--M----------M?----------MXXMX---XXM?---------------XM---XX--M-------oo------------------MX?----------------------------------M------XXXXM-----X------f-
-oXMM----------------------------XX?----X---M--------B------B--X-------?------------------XX------------------X---oE-?X----------------------XXXM------X-------E-------------------o-------------X----f-
--M--MX---o----X-------T---------------------------B------T------T---o-----------B------T------------------------oXX-----------------XMX-----------T-----?MXX----?MME-----?------ooX----T-----o-oX?MX-f-
----------XM?----------|-----------------------------oX---|------|---X------------------|--------------------?---T-------------?--------------B----|X--TX----Mo-----------E-----------T-|-----XXX-----f-
----------T------------|--------T---------------X---------|------|--B--?--------T-------|-----E--T---------------|-----------------?X------T-------|T--|-----X-T----X-----?-----------|-|-------------f-
m-T-T--XX-|----TE-E--E-|---XE---|--E-----B----X-E---------|----E?|--T--X---E----|T--TE-T|--E--X--|-E-------------|--M--------------T----XT-|-----T-||-T|-----TT|-----------BE-----T---|-|-----------E-X-
XXXXXXXXXXXXXXXXXXXXXXXXXXXXXXXXXXXXXXXXXXXXXXXXXXXXXXXXXXXXXXXXXXXXXXXXXXXXXXXXXXXXXXXXXXXXXXXXXXXXXXXXXXXXXXXXXXXXXXXXXXXXXXXXXXXXXXXXXXXXXXXXXXXXXXXXXXXXXXXXXXXXXXXXXXXXXXXXXXXXXXXXXXXXXXXXXXXXXXXX
