--------------------------------------------------------------------------------------------------------------------------------------------------------------------------------------------------------
------------------------------------o-------------------M---X----------------X-X-----------X--------------------------------------------------X----------------------------?---X--------------------M---
---------------------?-M--------------X-------------o---?-------------X-------------X---------------X----------------------X---M-------?---------X------------------------------------------------------
------------o-----------o-------B---X---------------?---------------------X-------X-----------------------------X------------X-B------------------------------------------------------E---?---?---------
--X-----X------------------X------X------------------X----X------------------X----------?X--------X-----X-----------X--------------------X--------X-------------o-------------X---------------------M---
--B--XM?-------X----------------------?--------X-oX----B--o------X???X----------------------------X---E-------oXX-----------------------------X-----------------------------?----?X----o-X?oX-----------
---X-----?-------B---------------oX-E--------XMXX--------XXX-M----?------XXXoX--------o--?o--X?------XX--XXMo--------------------oX-X----------------X-----------XX-----------------MoX?X--X------------
---------------------X--------oM------X-----------------------------------------XM--X-X---X-B-------X------------Xoo------------XX--?MMM---M------o-X--------X--X----XM-------------------------------v-
-----Mo-----------B------?XX-----E------------------------------------------------o-o----B---------------------------oXXoX---?MX-------------o---X?oX---X----XM-----------Mo-----XX------------------of-
-MX------------------------------XXX---------------X--X------X-M-?X?-----oX------XXM?-----------------------------------XX-------------------?-----B-----X------XXX-----------X--?X-X------------XXX--f-
---------o------------oo---------------------o?oXX-----------XM------X------X-------------MX?M-------XMXXo-X-X--------o-----------M?--------E--------X------------------------------------o-?-B------Xf-
---------X-----------MXXX---------o--------M----------------T--------T-----------BM--oMXTX--------T--------E-o-----X-XX-----------T---ooE---------------T------------oXX-----X?---o--XMT-o?--T--------f-
----------T--MXXMX-TX----------T-----------T-------------T--|T-----T-|T------?Xo--------|---------|----------X-----------XX?X?XXXT|--XX??M-----T------TX|----XXX--T-T------T------?----|X----|T---?---f-
----------|------M-|-----------|--TT-------|-------------|--||-----|T||-T------XT-----X-|-T-------|-----------T---o-------T----X-||X-----------|M-----|-|---------|-|o-----|T----------|----X||-------f-
m----?--E-|B-------|---X---T--X|--||------T|E------------|--||----T||||-|-TTM---|T--TE-T|-|--E----|T----------|-----------|------||----T-----XE|--T-B-|-|----X----|-|X---T-||T-E-------|-----||-------X-
XXXXXXXXXXXXXXXXXXXXXXXXXXXXXXXXXXXXXXXXXXXXXXXXXXXXXXXXXXXXXXXXXXXXXXXXXXXXXXXXXXXXXXXXXXXXXXXXXXXXXXXXXXXXXXXXXXXXXXXXXXXXXXXXXXXXXXXXXXXXXXXXXXXXXXXXXXXXXXXXXXXXXXXXXXXXXXXXXXXXXXXXXXXXXXXXXXXXXXXX
