--------------------------------------------------------------------------------------------------------------------------------------------------------------------------------------------------------
--------------------------------------------------------------------------------------------------------------------------------------------------------------------------------------------------------
--------------------------------------------------------------------------------------------------------------------------------------------------------------------------------------------------------
--------------------------------------------------------------------------------------------------------------------------------------------------------------------------------------------------------
--------------------------------------------------------------------------------------------------------------------------------------------------------------------------------------------------------
-------------------------------------------------------------XX------------------------------XX?X------------------------------------------------------------XX--------------Xo--XXX-------------XX?----
-------------?ooXX---------------------------XX----------------------------------oXX-----------------------------oXXoX---------------------------------o---------Xo-------------------------------------
-------------XXXXX---------------XX------------------------------------------------------------------------------------------XX----------------------X?XX----XX--X?------?XXXX-------------------------v
---------XXoXX-----------------------XXX-----------------------------------------XX--------------------------------------?X------------------?XXXX-------------------------------?XX?------------------f
-----XXXXX---------------------------------------------------------------Xo----------------------------------------------------------------------------------------------------------X?----------------f
---------------------X?X?----------------------------------------------------------------------------------------------------------------XXXXXXXX------------------------------------------------XX----f
--------------------T---------------T----T---------------XX--------------------------------------------------------------------------------------------------------------------T---------XX?-----------f
-?X----------X?Xo---|---------------|XX--|-----------T---Xo?X--------------------X??-----T-------------------------T----------------------------------------------------TT-----|-XX?XXXX?--------------f
-----T--------------|---------------|----|-----------|---XX---------------T--------------|-------------------------|----------------------------------------------------||---T-|-----------------------f
m----|-------------T|E------T-------|----|----T------|----------------T---|E-------------|-------EE----------------|-----------------E--------E-E-E----E----------------||---|-|-----------------E-E---X
XXXXXXXXXXXXXXXXXXXXXXXXXXXXXXXXXXXXXXXXXXXXXXXXXXXXXXXXXXXXXXXXXXXXXXXXXXXXXXXXXXXXXXXXXXXXXXXXXXXXXXXXXXXXXXXXXXXXXXXXXXXXXXXXXXXXXXXXXXXXXXXXXXXXXXXXXXXXXXXXXXXXXXXXXXXXXXXXXXXXXXXXXXXXXXXXXXXXXXXX
